//MAP CONVERTED BY dmm2tgm.py THIS HEADER COMMENT PREVENTS RECONVERSION, DO NOT REMOVE
"a" = (
/obj/decal/tile_edge/wayfinding_line/command{
	dir = 1;
	pixel_x = 13
	},
/obj/decal/tile_edge/wayfinding_line/medical{
	dir = 1;
	pixel_x = 6
	},
/obj/decal/tile_edge/wayfinding_line/civilian{
	dir = 1;
	pixel_x = -1
	},
/turf/simulated/floor/yellow,
/area/space)
"f" = (
/obj/decal/tile_edge/wayfinding_line/security{
	dir = 8;
	pixel_y = -12
	},
/obj/decal/tile_edge/wayfinding_line/engineering{
	dir = 8;
	pixel_y = -5
	},
/obj/decal/tile_edge/wayfinding_line/cargo{
	dir = 8;
	pixel_y = 2
	},
/turf/simulated/floor/yellow,
/area/space)
"t" = (
/obj/decal/tile_edge/wayfinding_line/command{
	dir = 4;
	pixel_y = 13
	},
/obj/decal/tile_edge/wayfinding_line/medical{
	dir = 4;
	pixel_y = 6
	},
/obj/decal/tile_edge/wayfinding_line/civilian{
	dir = 4;
	pixel_y = -1
	},
/turf/simulated/floor/yellow,
/area/space)
"v" = (
/obj/decal/tile_edge/wayfinding_line/security{
	dir = 2;
	pixel_x = -12
	},
/obj/decal/tile_edge/wayfinding_line/engineering{
	dir = 2;
	pixel_x = -5
	},
/obj/decal/tile_edge/wayfinding_line/cargo{
	dir = 2;
	pixel_x = 2
	},
/turf/simulated/floor/yellow,
/area/space)
"z" = (
/obj/decal/tile_edge/wayfinding_line/command{
	dir = 8;
	pixel_y = 13
	},
/obj/decal/tile_edge/wayfinding_line/medical{
	dir = 8;
	pixel_y = 6
	},
/obj/decal/tile_edge/wayfinding_line/civilian{
	dir = 8;
	pixel_y = -1
	},
/turf/simulated/floor,
/area/space)
"F" = (
/obj/decal/tile_edge/wayfinding_line/command{
	dir = 2;
	pixel_x = 13
	},
/obj/decal/tile_edge/wayfinding_line/medical{
	dir = 2;
	pixel_x = 6
	},
/obj/decal/tile_edge/wayfinding_line/civilian{
	dir = 2;
	pixel_x = -1
	},
/turf/simulated/floor,
/area/space)
"J" = (
/obj/decal/tile_edge/wayfinding_line/security{
	dir = 1;
	pixel_x = -12
	},
/obj/decal/tile_edge/wayfinding_line/engineering{
	dir = 1;
	pixel_x = -5
	},
/obj/decal/tile_edge/wayfinding_line/cargo{
	dir = 1;
	pixel_x = 2
	},
/turf/simulated/floor,
/area/space)
"V" = (
/obj/decal/tile_edge/wayfinding_line/security{
	dir = 4;
	pixel_y = -12
	},
/obj/decal/tile_edge/wayfinding_line/engineering{
	dir = 4;
	pixel_y = -5
	},
/obj/decal/tile_edge/wayfinding_line/cargo{
	dir = 4;
	pixel_y = 2
	},
/turf/simulated/floor,
/area/space)

(1,1,1) = {"
a
F
"}
(2,1,1) = {"
J
v
"}
(3,1,1) = {"
f
z
"}
(4,1,1) = {"
V
t
"}
